################################################################################
#                                                                              #
#                                 ##########          ###################      #
#                      #          #        #          #                        #
#         #########    #          #        #          #    ###########         #
#         #            #          #        #          #              #         #
#         #   ##       #          #        #          #              #         #
#         #   ##       ##       ###        ####      #####           #         #
#         #   ##                                                     #         #
#         #   ##       ################      ################        #         #
#         #                           #      #                                 #
#         #########               #   #      #                                 #
#                                 #   #      #                                 #
#                           ###   #   #      #                                 #
#                           ###                                                #
#    ##############         ###   #   #      #                           #######
#    #                            #   #      #                                 #
#    #            #               #   #      #   ##########    #########       #
#    #            #                   #      #                         #       #
#    #            #                   #      #                    ##   #       #
#    #            #                                               ##   #       #
#    #            #    ################      ##############       ##   #       #
#    #            #          #                            #            #       #
#    #     ########          #                            #    #########       #
#    #                       #                            #                    #
#    #                       #                            #    ##############  #
#    #                       ##########          ##########                    #
#    ######################                                                #####
#                                                                              #
################################################################################